#########........#.@@@.#
#................#.#.#.#
@.......########.#.....#
@..............#.#.....#
@......##......#.#...#.#
#......##......#.#...#.#
#..............#.#...#.#
###............#.......#
##.............#.......#
#......####..###.......#
#......#.......#...@...#
#......#.......#.......#
#..............#.......#
#......#########........
#.......................
##############.#........
##############.#........
##############.#........
##############.#........
##############.#........
##############.#........
##############.#........
##############.#........
############...#........
